1111111111111111
1000000000100001
1000000001110001
1000102000100001
1000000000111001
1111111111111111