NO /src/north.xpm

SO /src/south.xpm

EO /src/east.xpm

WO /src/west.xpm


1111111111111
1000000110001
1000000000001
1001110000001
1001000000101
100000N000001
1001101111111
1000100000001
1111111111111
