NO ./src/north.xpm

SO ./src/south.xpm

EO ./src/east.xpm

WO ./src/west.xpm

DO ./src/west.xpm

    111111111
    100000001
    100000001
1111100011111
1000000110001
111111111000111111111
        1000000000001
        1001131000001
111111111001000000101
100000W00000111111111
1001101111111
1000100000001
1111111111111
